W W W W W W W W W W W W W W W W W W W W 
 W W P H W W W U U U W W W W U U W W W W 
W W P W W W W W U W W W W U U W W U U W 
 W P W W U U W W U W W W U W W W W U W W 
W W P W W U U W W U W W U W W W W U W W 
 W W P W U W U U U W W U U W W W U W W W 
W W W P H W W W W U W W U U W W W U W W 
 W W P W W W W W W U W U W U W W W U W W 
W W P W W P P W W W U U W W U U U U W W 
 W P W W P W P W W W W W U W W W W W W W 
W W P W P W P P P P W W W U U U U U U W 
 W W P P W W W W W P H U W W W W W W U W 
W W W P W W W W P P W W W W P P W W U W 
 W W P P P W W P W P W G P P W P H U W W 
W W P W W P P W W P W W W W W P W W W W 
 W W P W W P P W W P W W W W P W W W W W 
W W P W W W P P W W P P P W P P P W W W 
 W P W W W W P W P W W W P P W W P W W W 
W W P P P P P P P P W W P W W W W P W W 
 W W W W W W W W W W W W W W W W W W W W 

